"a" = (/turf/closed/indestructible/riveted,/area/start)
"f" = (/obj/effect/landmark/start/new_player,/turf/open/floor/plating,/area/start)
"z" = (/turf/closed/indestructible/splashscreen{name = "DARKNESS: The Collapse"},/area/start)

(1,1,1) = {"
aaaaaaaaaaaaaaa
aaaaaaaaaaaaaaa
aaaaaaaaaaaaaaa
aaaaaaaaaaaaaaa
aaaaaaaaaaaaaaa
aaaaaaaaaaaaaaa
aaaaaaaaaaaaaaa
aaaaaaafaaaaaaa
aaaaaaaaaaaaaaa
aaaaaaaaaaaaaaa
aaaaaaaaaaaaaaa
aaaaaaaaaaaaaaa
aaaaaaaaaaaaaaa
aaaaaaaaaaaaaaa
zaaaaaaaaaaaaaa
"}
